3,9536,1664 3,9056,1440 3,9120,1664 8,1504,384 8,1536,928 3,1472,352 3,7648,64 3,8256,1184 3,4704,896 3,7936,1280 3,3168,1024 3,6176,1184 3,6080,1120 
3,9184,1408 3,1856,544 3,6496,576 3,2176,320 3,7968,1280 3,2432,1024 3,9312,1216 3,704,192 3,9600,1856 3,800,224 3,6304,1152 3,7744,32 3,128,160 
3,9216,1344 3,32,192 3,4928,896 3,7328,544 3,320,576 3,736,192 3,1824,512 3,448,512 3,3552,832 5,8320,1024 3,160,128 3,8768,1216 3,640,512 
3,6080,1152 3,7648,160 3,3584,832 3,5216,1120 3,5952,1120 3,7552,416 5,1440,352 3,160,576 3,6176,544 3,5312,1088 3,224,256 3,5760,1056 3,-32,128 
3,7808,96 3,1632,1024 3,1824,1088 3,3680,768 8,1248,800 4,32,352 3,1344,320 3,5376,1056 3,1088,192 3,4960,896 3,9280,1216 3,6304,1120 3,3936,544 
3,32,576 3,7808,64 3,3488,928 5,2080,288 4,0,320 4,256,288 3,5664,928 3,9504,1216 3,4736,928 3,5792,1088 3,6272,1024 3,9248,1216 3,9696,1280 
3,6368,544 3,9312,1632 3,4320,416 3,1152,192 5,4064,576 3,5024,864 3,864,192 3,416,512 3,32,256 3,7360,544 3,9600,1216 3,96,576 3,896,416 
3,6304,1024 3,3616,832 3,8256,1024 3,9632,1856 3,9472,1760 3,9696,1312 3,7648,128 3,4992,864 5,2176,384 3,192,160 3,2208,1184 3,6528,608 8,2336,1024 
3,8832,1216 3,7488,480 3,1184,704 3,864,416 3,8096,1184 3,9664,1824 4,32,384 3,288,192 3,3392,928 3,4768,928 3,9696,1248 3,6592,608 3,6336,1024 
3,7808,1312 3,7424,544 3,8160,1184 5,288,288 3,6656,640 3,8896,1216 3,384,544 3,224,416 4,256,320 8,2144,1184 3,480,512 3,6048,1120 3,7872,1312 
3,7808,32 3,6144,544 5,9504,1856 3,3200,992 3,288,256 3,64,576 3,1056,576 3,1120,608 3,9216,1664 3,6752,672 3,8928,1248 3,928,192 3,1600,992 
3,9440,1216 3,4096,576 3,224,320 3,6144,576 3,1568,384 3,8960,1664 5,256,576 3,3648,800 3,32,224 3,8672,1120 3,32,128 3,5632,928 3,1184,672 
3,1248,256 3,4864,928 3,800,416 3,5728,1056 3,2016,416 3,128,128 3,2048,416 3,1280,864 3,8960,1248 3,9472,1216 3,5920,1088 3,7456,512 3,1472,384 
3,192,352 3,1216,768 3,672,512 3,7648,32 3,1184,768 3,5856,1088 3,6720,672 3,6432,544 3,9184,1664 3,9344,1600 3,8992,1344 3,8928,1216 3,2176,288 
3,2048,288 3,2240,1184 3,9696,1344 3,352,544 3,7008,672 5,4800,928 3,32,320 3,4352,384 3,6560,608 3,6624,608 3,7680,1280 4,224,352 3,384,512 
3,768,224 3,9664,1216 3,1248,832 3,224,224 3,7488,512 3,5056,1088 5,7392,544 3,3232,992 3,768,448 3,1472,896 3,4032,576 3,7904,1280 3,4832,928 
3,288,352 3,9536,1728 4,0,352 3,9280,1632 3,64,352 3,6400,544 3,8096,1216 3,3456,928 5,832,416 3,2784,864 5,256,128 3,8928,1632 3,1568,416 
3,9088,1664 3,7712,1312 4,224,384 3,1216,800 3,64,416 3,2304,1024 3,0,128 3,6624,640 3,1664,1024 4,256,352 3,1504,896 3,1568,992 5,1792,1056 
3,8480,1024 3,64,128 3,6144,1152 3,2944,736 3,9312,1600 3,4128,608 3,32,288 3,4000,576 3,8032,1248 3,6432,576 3,7648,1280 4,0,192 3,1536,960 
3,3968,544 3,1952,544 3,2272,1184 3,192,128 3,3520,832 3,6048,832 3,8928,1664 3,736,480 3,1632,992 3,7808,192 4,0,256 3,1984,512 3,5952,1088 
3,1408,320 3,9184,1376 3,3424,928 3,6240,1184 3,8000,1248 3,5824,1088 3,9568,1856 3,2976,736 3,9472,1728 3,832,192 3,4384,384 3,7680,160 3,736,448 
3,6208,1184 3,9344,1216 3,928,448 3,5056,1120 3,6656,672 3,5088,1120 3,9248,1664 3,4160,608 3,1568,960 3,7872,1280 3,9664,1728 3,2176,1184 3,1664,1056 
3,2464,1024 3,5792,1056 3,9024,1440 3,1504,928 3,-32,192 3,8992,1376 3,768,192 3,2144,288 3,1312,864 3,3616,800 3,4704,928 3,9088,1472 3,7616,1280 
3,5280,1120 3,9216,1248 3,128,576 3,5024,1088 3,96,160 3,9664,1248 3,7616,1248 5,1216,256 3,9664,1696 3,5696,1056 3,1280,832 3,9504,1728 3,7808,128 
3,9056,1664 3,1184,256 3,704,480 3,9408,1216 3,6304,1056 3,2048,352 3,5184,1120 3,1696,1056 3,9536,1216 3,4320,384 3,1408,352 3,5888,1088 3,7680,1312 
3,1088,608 3,768,416 3,8192,1184 5,2752,864 3,8288,1024 3,1152,640 3,8640,1120 3,6304,1184 5,7744,1312 3,9152,1440 3,192,384 3,3968,576 5,6208,544 
4,0,224 3,5120,1120 4,0,288 3,224,128 3,288,224 3,4288,416 3,7648,192 3,7776,1312 3,6464,576 3,9248,1632 3,288,128 3,1760,480 3,5536,928 
3,64,384 3,8896,1632 3,256,384 3,1824,544 3,1792,480 3,8224,1184 3,2080,1184 3,4128,576 3,32,416 3,9536,1856 5,32,160 3,1792,512 3,3008,736 
4,256,224 3,1152,672 3,1088,576 3,7968,1248 3,2016,480 3,8800,1216 3,5408,1056 3,5504,960 3,9664,1760 3,288,576 5,6304,1088 5,896,192 4,256,256 
3,6112,576 5,8864,1216 3,3200,1024 3,4896,928 4,256,192 3,8064,1216 3,9472,1824 3,2400,1024 3,224,192 3,7584,1248 3,9536,1696 3,320,544 3,224,288 
3,3680,736 3,4608,384 3,8992,1664 3,7648,96 3,192,416 3,2176,352 3,192,576 3,2720,864 3,4672,896 3,9664,1856 3,6080,832 3,6144,1184 4,0,160 
3,5600,928 8,9664,1792 3,9024,1664 3,8512,1024 3,288,160 3,2688,864 3,3520,928 3,3744,480 3,2112,1184 3,1120,640 5,9632,1216 3,5536,960 3,2112,288 
3,5248,1120 3,96,128 3,2304,1184 3,7456,544 3,-32,224 3,0,384 3,8032,1216 5,7712,32 3,4960,864 3,1792,1088 3,7776,32 3,-32,160 3,-32,288 
3,5440,1056 3,1696,448 3,1696,416 3,6304,992 3,-32,256 3,-32,320 3,9248,1248 3,1152,224 3,960,448 3,8992,1312 3,3648,768 3,5568,928 3,7840,1312 
3,6688,672 3,4928,928 3,5344,1056 3,8128,1184 3,288,320 3,3712,480 3,1120,192 3,9216,1312 8,1728,1056 3,1344,288 3,1536,384 3,6944,672 3,224,576 
3,6976,672 3,928,416 3,5312,1056 3,6496,608 5,9216,1280 3,1728,448 3,1760,448 3,6272,1184 3,2048,384 3,5152,1120 3,7808,160 3,9376,1216 3,2368,1024 
3,7584,288 5,9152,1664 3,224,160 3,160,160 3,960,480 3,8544,1024 4,256,160 3,800,192 3,2272,1024 5,9568,1216 3,-32,352 3,1184,736 3,2176,416 
3,9024,1408 3,9472,1856 3,4576,384 3,64,160 3,7680,32 3,1376,320 3,2016,448 3,1184,224 3,8960,1280 3,5280,1088 3,4256,416 3,6112,1152 3,7200,544 
3,704,512 3,3776,480 3,1760,1056 3,2048,320 3,9120,1472 3,8992,1408 3,9472,1792 