3,2016,32 3,5856,256 3,6720,672 3,6368,288 3,448,224 5,1024,160 3,4448,128 3,768,256 4,32,96 3,6592,608 4,64,64 3,2688,128 3,192,32 
3,416,224 4,96,64 4,6752,736 3,2048,32 5,5888,256 3,6784,736 3,192,128 6,0,160 3,4704,192 3,3840,480 3,5056,160 3,6336,800 3,0,128 
3,6272,288 3,1568,352 3,6784,608 5,4992,128 3,6432,384 3,3296,480 3,1760,288 3,6208,416 3,6688,544 3,3360,480 3,4640,192 3,5408,608 4,64,96 
3,6592,544 3,5920,256 3,2848,192 3,6624,832 3,1728,288 9,1216,64 3,5728,576 3,6304,480 3,6080,256 3,5088,192 3,3168,192 3,0,96 4,6720,800 
3,6240,288 3,64,32 4,224,128 4,192,64 3,800,256 3,128,32 3,6560,608 4,160,64 3,64,128 3,5472,640 3,6304,768 3,6656,544 3,6432,416 
5,3552,384 3,1088,160 4,6720,576 8,6432,640 9,3584,384 4,6752,768 3,256,96 3,5536,640 4,6560,800 3,6624,768 3,3744,512 8,6272,416 3,384,224 
3,6784,576 3,6784,800 3,6528,800 3,2208,96 3,6304,736 3,96,32 3,6688,608 3,3712,320 3,6688,768 3,6304,640 6,2624,128 4,6656,576 3,6784,672 
5,5280,256 3,5984,256 3,128,96 3,5440,608 3,160,32 3,224,160 3,5312,256 3,6656,608 4,6560,576 3,6208,288 3,2656,128 3,6432,608 4,6688,576 
3,6304,416 9,3520,384 3,5248,256 3,6432,448 3,6240,416 3,6784,640 3,6624,544 5,6016,256 3,3008,288 3,6400,800 3,6592,768 3,6784,704 3,2400,32 
3,1408,416 3,160,96 3,6560,544 3,0,64 3,6720,608 3,5504,640 4,192,96 3,3744,320 3,6304,448 3,3072,288 3,6432,512 3,3872,480 3,6336,288 
3,6304,576 3,2880,224 4,6592,800 3,6432,480 3,5760,576 3,6400,288 3,512,256 3,1984,32 4,6688,800 3,4224,416 3,1536,352 3,6720,704 3,1376,416 
3,1792,288 4,224,96 3,1184,64 3,4480,128 3,4864,96 3,6368,800 3,32,64 5,1344,416 3,6752,544 3,4192,416 3,6528,576 3,6048,256 3,960,320 
4,6752,704 3,4352,320 3,6784,768 3,6656,832 4,32,128 3,6432,352 3,5024,160 4,6752,608 8,4064,480 3,6560,768 3,6304,544 3,928,320 4,6624,576 
8,256,160 3,3680,320 3,6304,608 4,6752,672 4,6624,800 3,6432,800 3,3712,512 3,224,64 3,3680,512 3,6304,288 3,6592,832 4,6752,800 4,6656,800 
3,6304,512 3,6560,832 3,1248,64 3,6656,768 3,2368,32 3,4320,320 3,5120,192 3,96,96 3,6720,768 3,6720,832 3,1952,32 3,3040,288 3,2336,32 
3,3392,448 3,6720,640 3,2176,96 3,6432,544 3,3904,480 3,4512,128 4,6592,576 4,128,64 3,256,128 9,480,224 3,6304,704 3,2528,64 5,6432,320 
3,6720,544 3,4032,480 3,256,64 8,4672,192 3,6688,832 8,3328,480 3,6720,736 6,6304,672 3,6624,608 4,6752,576 4,6752,640 3,32,160 3,2144,96 
3,992,320 3,5952,256 9,736,256 3,5376,576 3,544,256 3,6432,576 8,5696,576 3,6432,672 3,1056,160 3,6752,832 3,576,256 