3,64,128 5,3584,96 3,4224,448 3,6400,512 3,6656,256 3,5632,192 3,5792,288 3,6592,160 4,224,128 4,6592,128 3,1120,480 5,6624,96 3,2560,320 
5,640,160 3,992,128 3,320,256 3,6592,224 4,6624,256 3,6464,160 3,4704,160 5,5536,128 3,672,160 3,1088,224 3,6592,96 3,1664,320 4,6400,288 
4,128,128 3,3872,256 3,3616,96 3,5568,160 4,6496,128 3,5856,608 4,6400,160 3,2560,288 3,6304,512 3,352,352 3,1056,128 3,192,160 3,4864,96 
3,6656,288 4,6464,128 3,512,320 3,6432,96 3,6496,160 3,5344,352 3,3776,192 3,5312,352 3,384,384 3,5856,320 3,3168,416 3,3872,480 3,992,384 
3,1088,192 3,6400,320 3,96,160 5,2464,320 3,5728,256 3,6656,96 8,5888,608 3,2272,448 3,1056,480 3,1952,352 3,6560,96 3,800,64 3,352,320 
3,1024,480 3,6368,224 3,1088,256 3,4064,512 3,3424,96 3,3808,224 5,352,288 3,1184,672 3,992,416 3,6368,256 3,1152,672 3,5184,352 3,4672,160 
3,3712,160 3,3328,32 3,6432,288 3,2304,448 4,6400,224 8,5696,256 3,3904,512 3,2144,352 4,6400,256 3,2464,288 3,5824,320 3,6656,192 3,2112,352 
3,6400,96 3,5088,320 4,160,128 5,5056,320 3,2688,384 3,160,96 3,6656,224 3,5600,160 5,1088,480 3,3936,512 3,2752,288 3,1888,352 3,5664,224 
3,4352,160 3,6464,96 4,6400,128 3,6592,288 3,4512,224 5,1440,608 3,4096,512 3,6368,160 3,224,160 3,5120,352 3,1408,608 3,6592,192 3,5152,352 
4,96,128 3,4192,448 3,6592,256 5,1696,320 4,6560,128 3,6560,160 4,192,128 3,3200,288 5,3968,512 3,6368,192 3,1376,608 5,6528,160 3,1248,672 
4,6400,192 5,3840,256 3,6432,224 3,128,160 3,128,96 3,1632,320 4,6432,128 3,576,160 3,6080,544 3,6528,96 4,6624,160 3,2464,352 3,6656,160 
3,448,320 3,1024,128 3,992,448 3,608,160 3,5376,352 3,160,160 3,5984,608 3,3008,128 3,1088,160 4,6624,192 3,6432,192 3,2560,352 8,5888,320 
3,3744,192 3,5472,128 3,6432,160 3,5056,288 3,5760,288 3,928,128 5,3040,448 3,480,320 3,2848,320 3,3552,96 3,96,96 3,6496,96 3,2528,128 
3,5504,128 3,256,128 3,6656,128 3,6368,96 3,1920,352 3,416,352 3,1728,320 3,192,96 3,5024,288 3,6368,128 3,4480,224 8,6368,512 5,224,96 
3,6272,512 4,6624,224 4,6624,128 3,6368,288 4,6624,288 3,6336,512 3,1472,608 4,6528,128 3,4384,160 3,6624,320 3,6176,512 3,6432,256 5,960,128 
3,1216,672 3,1856,352 